000000000000000000000000000000000000
000000000000000000000000000000000000
000000000000222222222222220000000000
000000000000000000000000000000000000
000000000000000000000000000000000000
222222222222222222222222222222222222
111111111111111111111111111111111111
111111111111111111111111111111111111
111111111111111111111111111111111111